{
  "board": [
    ["W", "W", "W", "W", "F", "F", "W", "W", "W", "W", "W", "W", "W", "W", "W", "W"],
    ["W", "F", "F", "W", "F-P", "F-MB", "F-MB", "F-MB", "F", "F", "F", "F", "K#R", "F", "F", "W"],
    ["W", "W", "F", "W", "W", "F", "W", "F", "W", "F", "W", "F", "W", "W", "F", "W"],
    ["W", "F", "F", "F", "F", "F", "F", "F", "W", "F", "F", "F", "F", "F", "F", "W"],
    ["W", "F", "W", "W", "F", "W", "W", "F", "W", "W", "F", "W", "W", "W", "F", "W"],
    ["W", "F", "W", "F", "F", "W", "F", "F", "F", "F", "F", "W", "F", "F", "F", "W"],
    ["W", "F", "F", "F", "W", "F", "W", "W", "F", "W", "F", "F", "F", "W", "F", "W"],
    ["W", "W", "W", "F", "W", "F", "F", "F", "F", "F", "W", "W", "F", "F", "F", "W"],
    ["W", "F", "F", "F", "F", "W", "F", "W", "W", "F", "F", "F", "F", "W", "F", "W"],
    ["W", "F", "W", "W", "F", "F", "F", "F", "W", "F", "W", "F", "W", "W", "F", "W"],
    ["W", "F", "W", "F", "F", "W", "W", "F", "F", "F", "W", "F", "F", "F", "F", "W"],
    ["W", "F", "W", "W", "F", "W", "F", "F", "W", "W", "F", "W", "W", "W", "F", "W"],
    ["W", "F", "F", "F", "F", "F", "F", "F", "F", "F", "F", "F", "F", "T-R", "LD#R", "LX"],
    ["W", "W", "W", "F", "W", "W", "F", "W", "W", "W", "W", "W", "W", "W", "W", "W"],
    ["W", "F", "F", "F", "F", "F", "F", "F", "F", "F", "F", "F", "F", "F", "F", "W"],
    ["W", "W", "W", "W", "W", "W", "W", "W", "W", "W", "W", "W", "W", "W", "W", "W"]
  ],
  "level": {
    "number": 2,
    "Time Limit": 300,
    "Total Treasure": 3
  },
  "info": {
    "info": "Welcome to the maze!",
    "x": 1,
    "y": 4
  }
}